2222222222222222
2000000004000002
2033300000330002
2030004444030002
2030000000030002
2030444440030002
2000300000000112
2220300444441112
2000000300000002
2044440300444402
2040000000040002
2040444440040002
2040400000040002
2040451624440002
2000000000000302
2222222222222222