3333333333333333
3000000006000003
3066600000660003
3060006666060003
3060000000060003
3060666660060003
3000600000000773
3330600666667773
3000000600000003
3088880600888803
3580000000080003
3080888880080003
3080800000080003
3080899998880003
3000000000000403
3333333333333333