1111111111111111
1000000002000001
1022200000220001
1020002222020001
1020000000020001
1020222222020001
1000200000000331
1110200222223331
1000000200000001
1022220200222201
1020000000020001
1020222220020001
1020200000020001
1020233332220001
1000000000000501
1111111111111111