1 1 1 1 1 1 1 1 1 1 1 1
1 0 0 0 3 0 0 0 0 0 5 1
1 0 8 0 2 0 1 1 2 0 3 1
1 0 1 0 0 0 0 0 4 0 0 1
1 0 0 1 9 6 1 0 7 1 0 1
1 0 0 0 0 0 8 0 0 9 0 1
1 1 1 8 1 0 1 1 0 1 0 1
1 0 0 0 2 0 0 0 0 1 0 1
1 0 1 0 1 1 8 1 0 1 0 1
1 0 1 0 0 0 0 0 0 0 0 1
1 0 0 0 1 0 0 0 0 1 0 1
1 1 1 1 1 1 1 1 1 1 1 1
